0.2
level_3
level_select
enddoors
color
colored_bricks
endsigns
BBBBBBBBBBBBBBBBBBBBBBBBBBBB
B                       T  B
B                       D  B
B                          B
B                     BBBBBB
B                          B
B                          B
B                          B
B                          B
B                     MMMMMB
B                     M    B
B                     M    B
B                     M    B
B                     M    B
B                     MMMMMB
B                          B
B                          B
BCCCCCCC   CCCCCC          B
B                          B
B                          B
BMMMMM                     B
B                          B
B                          B
B          NNNNNN          B
B                          B
B                          B
B                     CCCCCB
B                          B
B          R               B
B       D     T            B
B          S     S         B
BBBBBBBBBBBBBBBBBBBBBBBBBBBB
