0.2
level_2
enddoors
Use space to fly
You can only fly for a short time
endsigns
BBBBBBBBBBBBBBBBBBBBBBBBBBBB
B                       T  B
B                       D  B
B                          B
B                     BBBBBB
B                          B
B                          B
B                          B
B                          B
B                     BBBBBB
B                          B
B                          B
B          BBBBBB          B
B                          B
B                          B
BBBBBB                     B
B                          B
B                          B
B          BBBBBB          B
B                          B
B                          B
B                     BBBBBB
B                          B
B          R               B
B             T            B
B          S     S         B
BBBBBBBBBBBBBBBBBBBBBBBBBBBB
