0.2
level_select
enddoors
Use space to fly
You can only fly for a short time
endsigns
BBBBBBBBBBBBBBBBBBBBBBBBBBBBBBBBBBBBBBBBBBBBBBBBBBBBBBBBBBBBBBBBBBBBBBBBBBBBBB
B                                                                            B
B                                                                         D  B
B                                                                            B
B                                                                       BBBBBB
B                                                                            B
B                                                                            B
B                                                        BBBBB               B
B                                                                            B
B                                                                            B
B                              BBBBBBBBBBBBBBBB                              B
B                                                                            B
B                                                                            B
B               BBBBB                                                        B
B                                                                            B
B                                                                            B
BBBBBB                                                                       B
B                                                                            B
B                                                                            B
B                                                                            B
B                                                                            B
B                                                                            B
BBBBBB          BBBBB          BBBBBBBBBBBBBBBB          BBBBB          BBBBBB
B                                                                            B
B                                                                            B
B                                                                            B
B                                                                            B
B                                                                            B
B                                                                       BBBBBB
B                                                                            B
B                                                                            B
B                                                                            B
B                                                                            B
B                                                                            B
B                          BBBBBBBBBBBBBBBBBBBBBBBBBBBBBBBBBBBBBBBBBBBBBBBBBBB
B                          B
B                          B
B          R               B
B          S        S      B
BBBBBBBBBBBBBBBBBBBBBBBBBBBB
