0.2
level_select
enddoors
watch out for ghosts!
endsigns
BBBBBBBBBBBBBBBBBBBBBBBBBBBBBBBBBBBBBBBBBBBBBBBBBBBBBBBBB
B                                                       B
B                                                    D  B
B                                                       B
B                                                  BBBBBB
B                                                       B
B             BBBBB               BBBBB                 B
B                                                       B
B                                                       B
B                       BBBBB                           B
B                                                       B
B                                                       B
B             BBBBB                                     B
B                                                       B
B                                                       B
B                                                       B
B                                                     G B
B                                                       B
BBBBBB        BBBBBBBBBBBBBBBBBBBBBBBBBBBBBBBBBBBBBBBBBBB
B                 B                  B                  B
B                 B                  B                  B
B                 B                  B                  B
B                 B                  B                  B
B                 B                  B                  B
BBBBBB            B      BBBBBB      B      BBBBBB      B
B                 B                  B                  B
B                 B                  B                  B
B                 B                  B                  B
B                 G                                     B
B                                                       B
BBBBBBBBBBBBBBBBBBBBBBBBBBBBBBBBBBBBBBBBBBBB      BBBBBBB
B                                                       B
B                                                       B
B                                                       B
B                                                       B
B                                                       B
B                                          BBBBBBBBBBBBBB
B                                      BBBBB
B               R                  BBBBB
B               T              BBBBB
B               S          BBBBB
BBBBBBBBBBBBBBBBBBBBBBBBBBBB
